111111111111
1C10101C1011
10000000P011
1010110X1011
110110011011
11100X001111
10C001000011
10000C0000E1
111111111111
